NO ./textures/tile210.xpm
SO ./textures/tile211.xpm
      WE ./textures/tile232.xpm


   EA ./textures/tile175.xpm    

F 75,    75,    75    
C 8,21,    37

11111111111111111111
10000000000000000001
10001111111111001001
10001000000000000001
10001000100011111111
10001000000000000001
10001111111111111001
100000000100010E1001
10001000010101000001
10001000010101001001
10111000010101001001
10001000010101001001
10000000000100001001
11111111111111111111