NO ./textures/blue.xpm
WE ./textures/brick.xpm
EA ./textures/green.xpm
SO ./textures/satan.xpm
F 224, 216, 215
C 128, 118, 117

11111111111111111111111111111111111
10000000011111111100000111111100001
10000000111111111100001111111110001
10000001100000001100001110011110001
10000011000000001100000000011110001
10000110000N00001100000000011110001
10001100000000001111000111111110001
10001111111111001111000111100000001
10001111111111001100000111100000001
10000000000011001100000111111110001
10000000000011001100000111111110001
10000000000000000000000000000000001
10000000000000000000000000000000001
11111111111111111111111111111111111