NO ./textures/tile175.png
SO ./textures/tile210.png
WE ./textures/tile211.png
EA ./textures/tile232.png
F 188,129,95
C 135,206,235
11111111111111111111 11111
10000000000000000001 10001
11111111001111111101 10001
       1001      101 11111
    1  1001 1111 101
       1001 1001 101
11111111001 1001 101
10000000001 1111 101
10000000001      101
10000000001111111101
10000000000000000001
10000E00000111111111
100000000001
100000000001 1111111
100000000001 1000001
111111111111 1111111
                    
11111111111111111111
10000000000000000001
10000000000000000001
10000000000000000001
11111111111111111111