NO ./textures/chest.xpm
WE ./textures/tileable.xpm
EA ./textures/stone.xpm
SO ./textures/clover.xpm
F 27, 156, 13
C 0, 128, 255

111111111111111
100000000010001
10000010S000011
100100000010001
100000100000011
100100000010001
100000100000011
100100000010001
100000100000011
100100000010001
100000100000011
100100000010001
100000100000011
100000000010001
111111111111111