NO ./textures/tile175.xpm
SO ./textures/tile210.xpm
WE ./textures/tile211.xpm


EA ./textures/tile232.xpm

F 188,129,95
C 135,206,235

111111
1001011
1010S01
1100011
111111