NO ./textures/blue.xpm
SO ./textures/green.xpm
WE ./textures/satan.xpm


EA ./textures/brick.xpm
F 188,129,95
C 135,206,235

        1111111111111111111111111
        1000000000110000000000001
        1011000001110000000000001
        1001000000000000000000001
111111111011000001110000000000001
100000000011000001110111110111111
11110111111111011100000010001
11110111111111011101010010001
11000000110101011100000010001
10000000000000000000000010001
10000000N00000001101010000001
1100000111010101111101110000111
11110111 1110101 101111010001
11111111 1111111 111111111111
